w------------------------------------w
r                                    0
r                                    0
r                                    0
p                                    0
r                                    0
r                                    0
r                                    0
w------------------------------------w
